袁咏仪	张智霖	夫妻	张智霖与袁咏仪越吵越恩爱，他是家中的顶梁柱，袁咏仪与张智霖从相识到如今,已经十多年了。
白崇禧	马佩璋	夫妻	婚礼时，白崇禧32岁，马佩璋22岁。
胡蝶	潘有声	夫妻	胡蝶原有结发之妻，还有女儿，为了潘有声，他抛妻别女。
郭松龄	韩淑秀	夫妻	郭松龄和爱妻韩淑秀从容下车，两人怜惜地稍一对望，都露出不屈的神色。
李嘉欣	许晋亨	夫妻	怀孕照曝光2010年9月，40岁的许晋亨，被《忽然一周》拍到跟妻子李嘉欣秘密前往香港养和医院。
鄢颇	梅婷	夫妻	2007年3月16日：梅婷公开承认已与鄢颇离婚。
詹才芳	杨静	夫妻	1955年授衔后，詹才芳与夫人杨静又一个金色的秋天到来了。
黄炎培	王纠思	夫妻	喜报传来，王老先生高兴异常，择定良辰吉日，让黄炎培和自己的女儿王纠思小姐拜了天地。
刘欢	卢璐	夫妻	刘欢与老婆卢璐现身，卢璐头戴绿巾抢镜，刘欢一身黑衣显年轻
高凌风	金友庄	夫妻	60岁的“青蛙王子”高凌风精力旺，台上台下永远活跳跳，金友庄是他第三任太太，结婚10年，生了3个孩子，但双鱼座的高凌风喜
英千里	蔡葆真	夫妻	蔡葆真:英千里的妻子，出身宦门，其父蔡儒楷是上世纪二十年代的山东省长
冯远征	梁丹妮	夫妻	尽管有阻力，但梁丹妮的坚定打动了冯远征，一年之后，两个人正式结为夫妇。
马小曼	燕守平	夫妻	燕守平的妻子马小曼是京剧旦角演员，马连良之女。
孙尚香	刘备	夫妻	孙尚香趁刘备丧偶之机，将孙权许于刘备和亲。
郁达夫	王映霞	夫妻	郁达夫王映霞的第一次婚姻是典型的旧式婚姻，是在父母之命、媒妁之言下的结合
叶剑波	傅明宪	夫妻	傅明宪与叶剑波1998年结婚，2006年中叶剑波卷入涉嫌诈骗案及失踪，2007年9月叶剑波返港时被捕。
田中直纪	田中真纪子	夫妻	田中直纪是日本前首相田中角荣的女婿，他的夫人田中真纪子曾经担任过日本外务大臣。
乔艳蕊	史冬鹏	夫妻	2013年11月2日，乔艳蕊与中国男子田径队110米栏名将史冬鹏在河北保定锦江国际电谷酒店举行婚礼。
蒋百里	查品珍	夫妻	的原配夫人，是金庸的同族姑母，蒋百里18岁时与查品珍订婚。
王义夫	张秋萍	夫妻	1987年初，因奥运相识相知的张秋萍与王义夫终于走进了婚姻的殿堂。
陆游	唐婉	夫妻	陆游唐婉表妹兼第一任妻子，陆游和唐婉是表兄妹。
吴君如	陈可辛	夫妻	陈可辛和吴君如对怀孕一事低调到了极点，吴君如在自己肚子已经很大的时候还是坚称没有怀孕，生产那天也是毫无预兆就“偷偷”去了医院
松赞干布	文成公主	夫妻	娶到文成公主后，松赞干布如愿以偿，喜出望外。
卫长公主	栾大	夫妻	元鼎五年,武帝宠信栾大,把卫长公主嫁给他,婚后,武帝将公主的封地改名为当利,卫长公主又号为当利公主.
张学友	罗美薇	夫妻	罗美薇与丈夫张学友的恋爱过程，也和普通人一样，经历了甜蜜、争吵，直到平
朱家鼎	钟楚红	夫妻	钟楚红与丈夫朱家鼎一起出席活动。
赵兰坤	连震东	夫妻	1936年8月27日,连震东的妻子赵兰坤在西安生下连战。
孙燕姿	纳迪姆	夫妻	在亲友的祝福下，孙燕姿终于和交往5年的纳迪姆步上红毯，开心地成为人妻。
董必武	陈碧英	夫妻	只有新娘子陈碧英的到来,第一次带给董必武这个职业革命家一个真正的“家”的感觉。
沈银河	池尚昱	夫妻	2005年，沈银河与大学研究院研究员池尚昱结婚，与沈银河共结连理的大学教授池尚昱 行事非常低调，两人的婚礼不邀请艺人。
穆铁柱	王专红	夫妻	穆铁柱和王专红结婚已经37年了。 提起当年结识的往事，王专红言语间不经意流露出当年的甜蜜。
王恩茂	骆岚	夫妻	婚后王恩茂、骆岚共养育子女8人。
傅声	甄妮	夫妻	1977年，傅声与当时的著名歌手甄妮结婚，使用了整个美丽华酒店大堂，筵开二百馀桌，轰动一时，也成为人人称羡的对象。
琦琦	任达华	夫妻	如今看看任达华和老婆琦琦，一个是影帝一个是名模，两人演绎着娱乐圈中神仙眷侣般的浪漫神话。
宋丹丹	赵玉吉	夫妻	宋丹丹经过与赵玉吉短暂的二十八天接触后,她最终选择在自己生日当天也就是1997年8月25日,嫁给了这位赵玉吉先生! 
萧乾	文洁若	夫妻	作为萧乾的夫人，文洁若介绍说，萧乾心中一直是把冰心当作大姐看待的
罗海琼	费麒	夫妻	华谊女星罗海琼被证实于2010年1月24号与相恋多年的男友，华谊的副总裁费麒在北京柏悦酒店举行婚礼。
陈公博	李励庄	夫妻	陈公博几次自杀均被人发现，他的妻子李励庄把手枪藏了起来，并寸步不离地守着陈公博，防他再寻短见。
孙中山	卢慕贞	夫妻	在婚后的数年中,尽管孙中山回乡并不多,但每次回家,卢慕贞总为他缝制一套新衣服和鞋袜,
刘菁	许昱华	夫妻	平静、安宁的刘菁是个十分专一的女孩，在遇到许昱华之前，压根就没有对哪个男孩动过情。
梦鸽	李双江	夫妻	1990年梦鸽和双江结婚，因为年龄相差太大，舆论争议梦鸽是在借李双江完成自己的事业，此事引起争议。
朱芳雨	胡美	夫妻	2007年，朱芳雨与胡美秘密地领取了结婚证。
敬一丹	王梓木	夫妻	敬一丹的丈夫王梓木是她在考场上认识的,当时敬一丹考取了北京广播学院,王梓木考取了清华大学经济系。
谷开来	薄熙来	夫妻	薄熙来是开国元勋薄一波之子，其妻谷开来是原中国人民解放军总政治部副主任、新疆区委第二书记谷景生将军之女
胡友松	李宗仁	夫妻	李宗仁和胡友松在北京李宗仁先生的官邸举行了一个简单的结婚仪式,从此这对红颜少女和白发将军终于走到一起了
陈赓	王根英	夫妻	在此期间，陈赓与王根英相识，并结为夫妻。
冯潇霆	赵盈	夫妻	赵盈，现广州恒大足球队队员冯潇霆妻子，山东临沂人，毕业于四川大学新闻系，
王刚	郑艳东	夫妻	同郑艳东结婚以后，王刚认真地反省了前两次婚姻失败的教训，开始戒烟、戒酒，并且尽量顾及到郑艳东的感情，
梁欢	英达	夫妻	虽然英达和梁欢之间的开始有些“离经叛道”，但从各方面来衡量，“这对夫妻组合，反而更合适、更靠谱一些”
杨千嬅	丁子高	夫妻	杨千嬅与丁子高于2009年8月11日在拉斯维加斯注册结婚，2010年12月20日在香港补办婚宴，2012年6月5日杨千嬅剖腹产下爱子Torres。
马东敏	李彦宏	夫妻	李彦宏有今天的成功,最该感谢的人就是他的老婆马东敏,她总能在关键时刻,冷静的向李彦宏提出最勇敢的建议,
江珊	高曙光	夫妻	尽管这样说，但与高曙光离婚后，江珊至今没有再婚，其感情生活也相当神秘。
萧乾	文洁若	夫妻	萧乾夫人文洁若和青年作家谈巴金，内容是怀旧的，言语却极轻快。
庄姜	卫庄公	夫妻	庄姜是卫庄公(公元前757-前735年在位)的正夫人,齐国齐庄公(公元前794-前731年在位)的女儿,是中国历史上著名的标准美女。
李铭顺	范文芳	夫妻	范文芳与李铭顺因演《神雕侠侣》走红,现实中两人爱情长跑多年,29日在新加坡完婚。
李克勤	卢淑仪	夫妻	2007年在新碟《MyCupOfTea》发布会上，李克勤更承认太太卢淑仪怀孕。
黎民伟	林楚楚	夫妻	2009年1月，黎姿与马廷强在澳大利亚注册结婚。
成方圆	王刚	夫妻	2001年4月，王刚和成方圆正式办理了离婚手续，王刚的第二次婚姻结束了。
洪金宝	曹恩玉	夫妻	据洪金宝自已所说，他与曹恩玉结婚是因人在异乡，又有人对自己好照顾，好容易日久生情。
陈公博	李励庄	夫妻	李励庄的丈夫是中国民国时期的著名人物陈公博，但李励庄从不干涉陈公博的政事。
沈坚强	庄泳	夫妻	可尽管沈坚强和庄泳同为国家队队友，但是两人的结合却是后来的事情。
邵逸夫	方逸华	夫妻	1952年,方逸华在登台期间,认识现时的丈夫邵逸夫,当时邵逸夫对她的歌艺尤为赏识。
翁狄森	蒋怡	夫妻	35岁的“黑美人”蒋怡与42岁的香港珠宝商、也是设计师的男友翁狄森(Dickson)爱情长跑12年,在香港注册结婚,
林瑞阳	曾哲贞	夫妻	林瑞阳第一眼看到曾哲贞就被她忧郁的眼神所吸引，在他心目中曾哲贞一直是开心无忧的小女
鲁豫	朱雷	夫妻	朱雷的妻子是主持人陈鲁豫，跟鲁豫算是青梅竹马，在大学期间跟鲁豫开始了恋爱,直到30岁时，两人又重新走在了一起并步入婚姻殿堂。
孙英杰	汪成荣	夫妻	2010年1月2日，中长跑名将孙英杰与丈夫汪成荣在青海西宁举办了婚礼，这也是他们的第二场婚礼。
苏岩	陶经	夫妻	因为陶经一直无法离婚,多年来苏岩只能甘当大自己17岁的陶经的“小三”历经10多年才正式成为陶经妻子。 
沈嘉伟	邱淑贞	夫妻	沈嘉伟生性害羞，每次见到记者都很不自在，相反其明星妻子邱淑贞就淡定多了，沈嘉伟在过去共斥资1.2亿买下九个豪宅，曾升值达1.7亿元
李心洁	彭顺	夫妻	2002年,彭顺与李心洁结缘,当时李心洁担任彭顺执导作《见鬼》的女主角, 彭顺与李心洁 其后两人感情突飞猛进。
李敖	王小屯	夫妻	1988年6月，在经历了漫长的三年爱情长跑以后，王小屯终于成为了李敖的妻子。
钟丽淇	拿度	夫妻	钟丽淇和老公拿度同于2005年被娱乐圈中人所伤，女方白送梁荣忠多年青春；而男方也被一脚踏两船的花心女胡杏儿搞到香港美国两地奔波。
章含之	乔冠华	夫妻	在与乔冠华结婚之前，章含之有一场失败的婚姻。
钟丽淇	拿度	夫妻	已经怀有四个月身孕的钟丽淇，2010年10月与拿度低调在教堂举行婚礼。
林淑如	郭台铭	夫妻	郭台铭疼老婆也是非常出名的，林淑如在去世前就拥有13亿资产，而郭台铭也曾花费数亿在捷克用林淑如的名字买了一座古堡送给林淑如。
陈红	陈凯歌	夫妻	陈凯歌和陈红有两个可爱的儿子:陈雨昂和陈飞宇,大儿子陈雨昂长得像陈凯歌,性格却像陈红,小儿子陈飞宇长得像陈红,脾气却像陈凯歌。
曹敏莉	张家杰	夫妻	2010年9月曹敏莉和张家杰在美国纽约注册结婚，2010年10月28日晚于四季酒店举行婚礼
嫦娥	后羿	夫妻	受了委曲的后羿和妻子嫦娥只好隐居在人间，靠后羿打猎为生。
邢李源	林青霞	夫妻	邢李，1990年辗转入股Esprit美国公司，1994年与著名电影演员林青霞结婚，现有三个女儿。
毛新宇	刘滨	夫妻	毛泽东的嫡孙毛新宇与夫人刘滨，带着6岁的儿子毛东东、1岁零4个月的女儿毛甜懿一家四口来到毛主席纪念堂献上花篮。
朱德	贺治华	夫妻	36岁的朱德和19岁的贺治华再结良缘，并一同到德国哥廷根城奥古斯特大学学习社会科学。
潘石屹	张欣	夫妻	潘石屹捐1亿美元给海外引热议,随后,潘石屹老婆背景备受关注,潘石屹老婆张欣是其第二任老婆,1995年潘石屹与老婆张欣共同创立了SOHO中国有限公司。
张学良	赵一荻	夫妻	1964年7月4日,张学良与赵一荻正式结婚,结婚典礼在台北市杭州南路美籍友人的寓所举行。
申雪	赵宏博	夫妻	2013年4月，申雪，赵宏博欣喜地宣布，申雪已经怀孕20周零1天，预产期是9月4日，正是两人举行冰上婚礼的三周年纪念日。
斯内德	约兰特	夫妻	据悉，斯内德已经向约兰特求婚，而西班牙女星也接受了荷兰中场的钻戒。
田不易	苏茹	夫妻	一向眼高于顶的苍松道人临行前也叮嘱了他：田不易气量不大但修行极高，加上他夫人苏茹也是青云门中有名的才女，便是掌门道玄真人也敬他夫妇三分.
李益群	谢亚龙	夫妻	有消息称，谢亚龙夫人李益群也参与了不少事情。
宋任穷	钟月林	夫妻	宋任穷与钟月林一共养育了8个子女在“文革”的非常日子里,没有一个变坏的,这与宋任穷的严格家教是分不开的.
阎维文	刘卫星	夫妻	阎维文只有一个老婆,就是刘卫星。妻子刘卫星为有一个体贴入微的好丈夫而自豪;阎维文为身后有一个好后勤感到欣慰。
赵兰坤	连震东	夫妻	1936年8月27日,连震东的妻子赵兰坤在西安生下连战。
方敏仪	罗嘉良	夫妻	罗嘉良与拍拖多年的方敏仪1998年在加拿大结婚,二人在1998年于加拿大举行盛大婚礼。
邓拓	丁一岚	夫妻	1942年3月7日，邓拓与丁一岚以平山南滚龙沟一间农家小屋为洞房，结为夫妻。
张丹峰	洪欣	夫妻	《深宫》中是张丹峰同洪欣的第二次合作，也是婚后的第一次合作。
陈茹玉	何炳林	夫妻	抗战胜利后陈茹玉与同班同学何炳林结为伉俪，1946年夫妇俩来到南开大学化学系任教。
赵文卓	张丹露	夫妻	赵文卓因工作携升级为妻子的张丹露短暂回国。其间,被媒体拍到爱妻小腹明显突出,疑似有孕在身
蔡一智	周雪芳	夫妻	周雪芳前夫是有“犯罪家族”之称的黄氏四兄弟中、排行最小的黄桂南,
刘国梁	王瑾	夫妻	刘国梁从不讳言自己是早恋,他和妻子王瑾是当年国家队的队友,经历长达15年的爱情马拉松后,最终在2006年终成正果。
贾琏	王熙凤	夫妻	王熙凤原以为,虽然因贾琏“乱搞”而大闹过,那夫妻相处的格局应该还能长久维系。
丫蛋	王金龙	夫妻	2009年4月13日10时18分,丫蛋与王金龙在众亲属的见证下完成“婚礼”,从婚礼开始的一刻起,整个现场就被浪漫和感动的氛围所环绕。
费德勒	米尔卡	夫妻	米尔卡（1978年4月1日—），女，出生在斯洛伐克，是瑞士网球选手罗杰·费德勒的妻子。
林觉民	陈意映	夫妻	尽管林觉民和妻子陈意映是奉父命结婚,先结婚后恋爱,但两人感情非常深厚,《与妻书》便是最好的证明。
陆侃如	冯沅君	夫妻	1929年，陆侃如在上海与冯沅君结婚，从此二人合作研究中国古典文学，成为文学界一段佳话。
郭京飞	鲍莉	夫妻	郭京飞是在鲍蕾的介绍下认识的鲍莉，两人更在相恋一个月后便闪婚了，后来鲍莉为了郭京飞的发展放弃事业，选择做全职太太相夫教子。
伍咏薇	练海棠	夫妻	1998年,经黎姿介绍,伍咏薇认识了现任丈夫练海棠,二人恋爱7个月就闪电结婚,多年来一直很恩爱。
李焕之	李群	夫妻	李群的丈夫是李焕之，是厦门同乡作曲家，1942年6月两人在延安结婚。
范曾	林岫	夫妻	范曾的第一人妻子是林岫,后因“文革”期间的一些问题范曾对林岫顿生‘憎恨’,即与林岫分道扬镳。
雒芊芊	陈天桥	夫妻	雒芊芊,现任盛大公司副总裁,丈夫是陈天桥，于1999年7月开始恋爱的,9月结婚,2001年生女。
铁扇公主	牛魔王	夫妻	铁扇公主，又叫罗刹女,是女妖中十分厉害的一个,长得漂亮俊俏,与牛魔王是夫妻。
林美贞	孙兴	夫妻	 林美贞、孙兴去年10月婚变,已过1年,两人还未办妥离婚手续,5岁的儿子孙恒也不知父母已分手.
杉内雅男	杉内寿子八段	夫妻	杉内雅男的夫人是杉内寿子八段,今年也已81岁,夫妇两人仍征战在职业赛场,令人肃然起敬。
梁咏琪	Sergio	夫妻	Sergio十分尊重梁咏琪是家人，对梁妈妈尤其呵护，当他知道梁妈妈吃素多年，他们决定婚礼当日以全素宴招呼亲友，梁妈妈对女婿赞不绝口。
刘邦	吕雉	夫妻	吕雉不足二十岁时嫁给刘邦，一年之后生汉惠帝刘盈，第四年刘邦起兵反秦离家出走.
杨威	杨云	夫妻	2008年的11月6日，杨威和恋爱多年的队友杨云举行了浪漫而隆重的婚礼，这次婚礼也成了中国体操队的一次大聚会。
林淑如	郭台铭	夫妻	走过走廊就可了解郭家人一起成长的历史，郭台铭、林淑如夫妇、一双儿女郭守正、郭晓玲，还有郭奶奶过去几十年的合照，显示出郭家人紧密的感情。
作家张爱玲	赖雅	夫妻	赖雅是现代著名女作家张爱玲的第二任丈夫 张爱玲和赖雅1956年8月,36岁的张爱玲与65岁的赖雅结婚。
林子萱	刘至翰	夫妻	2009年年初，刘至翰与林子萱的第一个孩子出生。
陈慧琳	刘建浩	夫妻	陈慧琳与刘建浩的童话式婚礼前晚於洲际酒店举行，婚礼上如同发放催泪弹，不论一对新人、双方家长及来宾，都被感动得流下喜悦的眼泪。
李嘉欣	许晋亨	夫妻	昨日，一份李嘉欣与阔少许晋亨递交到香港金钟红棉道婚姻注册处的“结婚申请”被媒体曝光，显示两人已于2008年10月28日注册
聂荣臻	张瑞华	夫妻	聂力5岁时，党组织为了保证聂荣臻夫人张瑞华母女的安全，决定将聂力寄养在上海一位工人家里，并将张瑞华送去了天津.
黄胜	严茜子	夫妻	有网友爆料说,黄胜和严茜子假离婚,离婚不离家,严茜子在黄胜的支持下,在德州明目张胆地敛财,开发房地产。
黄睿靓	陈致中	夫妻	陈水扁的儿子陈致中带着妻子黄睿靓,也现身在抗争的人潮中。
冯亦代	黄宗英	夫妻	结发之妻郑安娜去世后，1993年，80高龄的冯亦代与年近70的著名演员黄宗英（小名小妹）结为伉俪。
冯亦代	郑安娜	夫妻	结发之妻郑安娜去世后，1993年，80高龄的冯亦代与年近70的著名演员黄宗英（小名小妹）结为伉俪。
戚美珍	苗侨伟	夫妻	苗彤，出生于1991年，香港艺人苗侨伟和戚美珍之女，毕业于加拿大UBC大学。苗彤遗传了母亲的美貌，出落得亭亭玉立，被同学称为“校花”。
林徽因	梁思成	夫妻	梁思成的第一任妻子是林徽因。
赵子琪	路金波	夫妻	2011年7月16日，出版人赵子琪和演员路金波低调完婚，虽然婚礼低调，但在微博上还是引起了众多网友的关注。
徐威	张怡宁	夫妻	2009年10月18日，中国乒乓球领军人张怡宁与商人徐威的婚礼在北京盛大举行，婚礼上嘉宾云集，著名主持人崔永元担任司仪。
蒋孝章	俞扬和	夫妻	俞扬和，也是一个不为人多知的人物。他与蒋孝章结婚以至婚后多年，新闻传播媒体上从未出现他的报道；
范旭霞	朱时茂	夫妻	朱时茂夫人范旭霞比他小两岁,是和他同一年从山东烟台招进福州军区话剧团的,当时一个15岁,一个13岁,可谓是青梅竹马.
王蒙	崔瑞芳	夫妻	王蒙，作家崔瑞芳的夫人。
李蕙仙	梁启超	夫妻	1891年（光绪十七年）梁启超十九岁时入京与与长他四岁的李蕙仙成婚，李惠仙与梁启超结婚时，带了两位丫环，
李敖	王小屯	夫妻	1992年3月8日,李敖与王小屯认识八年后,终于结婚。 李敖在经历了大半生的风风雨雨后,总算找到了他最理想的爱人。
黄锦燊	赵雅芝	夫妻	1985年,赵雅芝与老公黄锦燊结婚,随后两人生下第三个儿子,并一直共同生活到今天。
张充和	傅汉思	夫妻	傅汉思的中文名原为傅汉斯,傅汉思是由其妻张充和所起,“汉”意为汉朝,“思”意为“思想”。
章含之	乔冠华	夫妻	在与章含之结婚之前，乔冠华有一场失败的婚姻。
徐子淇	李家诚	夫妻	徐子淇外出消遣，总会惹来哄动。为免引起麻烦，她跟丈夫李家诚看场电影也须高度戒备
欧锦棠	万斯敏	夫妻	4月28日,香港影星欧锦棠与妻子万斯敏在香港神学院举行第二次婚礼,
成方圆	王刚	夫妻	1996年10月，王刚和成方圆举行了简朴的婚礼，但大家知道这个消息却也差不多隔了半年有余。
江珊	高曙光	夫妻	江珊在接机口接到女儿，而前夫高曙光在女儿身后拎着行李。小女孩左手拉着妈妈、右手牵着爸爸，三人有说有笑，场面温馨。
周恩来	邓颖超	夫妻	1925年8月8日，是邓颖超和周恩来结婚的日子，他们没有仪式、没有满座的高朋，有的只是久别重逢后的温馨。
潘迪生	杨紫琼	夫妻	1988年杨紫琼与潘迪生结婚并退出娱乐圈，但婚姻只维持三年后离婚。
芦璐	刘国正	夫妻	芦璐在乒乓球场上的打法可与老公刘国正不太相同，她是直板反面弧圈，而刘国正是横板两面反胶。
孟庆南	王丽丽	夫妻	孟庆南、王丽丽夫妻以3万元起家，用了18年的时间，将武汉凡谷电子打造成国内最大的通信天馈系统射频器件独立供应商。
金铁霖	李谷一	夫妻	金铁霖是李谷一的学生,两人的感情逐渐从师生情过渡到爱情。
陈浩民	蒋丽莎	夫妻	2011年7月11日,陈浩民被曝与知名演员蒋丽莎在长沙市民政局登记结婚。
张蓉芳	胡进	夫妻	张蓉芳和胡进是一对把大悲大喜全部奉献给中国女排的非常夫妻；
孙鲁育	朱据	夫妻	孙鲁班的同胞妹妹孙鲁育，因为初嫁朱据，而被称为“朱主”，即嫁给朱家的公主也。
黄胜	严茜子	夫妻	黄胜的妻子严茜子在随黄胜来德州之前,一直在齐鲁书社从事编辑工作。
钟小江	刘若英	夫妻	乐坛“黄金剩女”的刘若英,被证实8月8日在夫婿及男方亲友陪同下于北京正式注册结婚
柯玉芝	李光耀	夫妻	星加坡内阁资政李光耀,与妻子柯玉芝结缡至今,时间已逾60年,两人的鹣鲽情深让世人感动。
林毅夫	陈云英	夫妻	林毅夫与陈云英，一对博士夫妻，两位名人，一个是世界银行副行长兼首席经济学家，一个是“中国特殊教育第一人”。
王敬之	谭雪	夫妻	谭雪和王敬之2009年3月2日登记结婚,但之后因为备战十一运会,并为重返国家队而拼搏,所以婚礼一推再推。
马蓉	王宝强	夫妻	《天注定》戛纳首映，王宝强现场亲吻妻子马蓉赚眼球
章含之	乔冠华	夫妻	章含之同丈夫乔冠华一起曾活跃在联合国外交舞台上。
高晓松	徐珊珊	夫妻	高晓松的妻子徐珊珊更新了微博称,她已经带女儿去探视了高晓松,也算在中秋佳节时全家团圆了一下
杭天琪	张泽民	夫妻	为结婚谈出娱乐圈的著名歌手杭天琪于1998年就与前夫张泽民离婚后重返演艺圈，后来结识了外籍男友并移居国外。
彭雪枫	林颖	夫妻	1941年彭雪枫与林颖结婚，两人育一子彭小枫。
李依依	柯伟	夫妻	李依依院士和她的丈夫中国工程院柯伟院士是“夫妻院士”，事业上两人比翼飞，成为一段佳话。
秦可卿	贾蓉	夫妻	贾蓉是秦可卿的丈夫,自己的妻子死后,无动于衷,宝玉却吐血,什么原因? 
佟晨洁	谢晖	夫妻	佟晨洁-婚姻前国脚谢晖与名模佟晨洁的婚礼12月7日在上海瑞金宾馆1号楼举行，这场婚礼正如预期的那样成为了名流云集、佳丽众多的聚会。
吴征	杨澜	夫妻	1999年,吴征与妻子杨澜创办阳光媒体投资事业集团,自1999年创始至2007年8月担任集团主席职务.
潘虹	米家山	夫妻	潘虹32岁那年，她与米家山离婚。
陈国邦	罗敏庄	夫妻	2009年12月3日陈国邦与罗敏庄结束7年爱情长跑，在香港高调注册结婚。
林子萱	刘至翰	夫妻	刘至翰与林子萱在结束一次不愉快的婚姻后,林子萱复出娱乐圈并结识了现任丈夫。
谷景生	范承秀	夫妻	谷景生和妻子范承秀有五个女儿(范承秀是范仲淹的后代)，谷望江、谷政协、小妹(小名，名字未知)、谷望宁(小宁)、谷开来(小丽)。
小S	许雅钧	夫妻	2010年6月，小S与丈夫许雅钧频频爆出“家暴”“丈夫流连夜店”等等八卦新闻。
王弢	刘璇	夫妻	2013年12月7日、8日，刘璇与王弢在香港补摆喜酒，举办婚礼。
张学良	于凤至	夫妻	张学良原配夫人于凤至，生三子一女，后有情妇“赵四小姐”。
赵雅芝	黄汉伟	夫妻	赵雅芝与黄汉伟结婚七年之后，便开始了分居生活，1982年赵雅芝与前夫黄汉伟正式离婚，并为了争夺两个孩子的抚养权而与前夫黄汉伟对薄公堂。
卓琳	邓小平	夫妻	2月19日,是邓小平逝世的祭日,每年的这个日子,夫人卓琳和儿女们都要在院子里撒满花瓣,因为邓小平喜欢花,喜欢香味。
李双江	丁英	夫妻	在几十年婚姻生活中，李双江与丁英育有一子，名为李贺。
周恩来	邓颖超	夫妻	1925年8月8日,周恩来与邓颖超结婚,并相濡以沫整整半个世纪。
周正龙	罗大翠	夫妻	罗大翠，1981年与周正龙结婚。
王文澜	倪萍	夫妻	倪萍于1997年与王文澜结婚,1999年40岁的倪萍生下儿子虎子。
史铁生	陈希米	夫妻	史铁生和陈希米结婚的时候，已经38岁，虽然陈希米也有轻度残疾，但从此“只有一条好腿的希米充当了铁生的眼睛和双腿”，直到生命的最后一刻。
林淑如	郭台铭	夫妻	林淑如:原台湾首富郭台铭的妻子,台湾首富郭台铭与小他24岁的舞蹈老师曾馨莹结婚。
郭台铭	曾馨莹	夫妻	林淑如:原台湾首富郭台铭的妻子,台湾首富郭台铭与小他24岁的舞蹈老师曾馨莹结婚。
孙艺洲	曹晓雯	夫妻	孙艺洲已经和上海戏剧学院的同学曹晓雯恋爱8年登记结婚,2011年9月9日举行婚礼。
石舫亘	蒋万安	夫妻	石舫亘,国民党副主席蒋孝严的儿子蒋万安的妻子。
杨长智	关心妍	夫妻	杨长智（Jonas）和关心妍(Jade)将于2009年10月20日起程往巴厘岛举行其梦幻
张爱玲	赖雅	夫妻	对于张爱玲与赖雅的结合，不少人更替张爱玲感到惋惜，以为一个年长张爱玲29岁的美国三流作家，晚年贫病交加，他能给张爱玲什么呢？
高秀敏	何庆魁	夫妻	高秀敏的家人始终对何庆魁不和自己的发妻张艳茹离婚,又不与高秀敏结婚的事情耿耿于怀,
谢道韫	王凝之	夫妻	谢道韫和丈夫王凝之有四子一女。
李心洁	彭顺	夫妻	 导演彭顺与李心洁结缘于2002年,李心洁担任彭顺执导作《见鬼》的女主角,其后两人感情突飞猛进。
甄子丹	汪诗诗	夫妻	妻子汪诗诗怀上龙凤胎，甄子丹也因为爱妻怀孕而日夜陪护在其身边。
杨振宁	杜致礼	夫妻	杜聿明的女婿、诺贝尔物理奖获得者杨振宁博士于1971年和1972年两次携夫人杜致礼回祖国探亲讲学。
胡美	朱芳雨	夫妻	2007年12月,朱芳雨和相恋3年的女友胡美领取了结婚证。
徐志摩	张幼仪	夫妻	这是一首徐志摩送给张幼仪女士的诗（作于1922年3月徐志摩和张幼仪在德国柏林离婚之后。
彭儒	陈正人	夫妻	陈正人与彭儒婚后育有子女6人,其对子女的教育非常严格,要求子女“要保持艰苦奋斗的作风”,
梁思成	林洙	夫妻	梁思成回家后，非常高兴地对林洙说：“现在我们的婚姻得到了第一书记的支持”。
唐涤生	郑孟霞	夫妻	1942年,唐涤生与擅长舞蹈的上海京剧名伶郑孟霞结婚。
买红妹	孙楠	夫妻	2009年7月15日，买红妹与孙楠协议离婚，房产等大部分财产归买红妹，家庭中两个小成员也找到了各自的归属，女儿跟孙楠，儿子则跟了妈妈买红妹。
佐藤荣作	佐藤宽子	夫妻	1926年佐藤荣作和佐藤宽子结婚,生有两子,次子佐藤信二曾为参议员。
李小琳	刘智源	夫妻	李小琳，丈夫刘智源,历任中国新华保险公司总经理助理,北华信电子集团总经理。
叶盛兰	刘淑卿	夫妻	-家庭成员叶盛兰娶妻刘淑卿，生有四女二子，叶莉珠（即叶黛森）、叶凤珠、叶金娣、叶玉珠姐
琦琦	任达华	夫妻	说起任达华的名模太太琦琦,可以说就算这个女人略施脂粉,穿上很普通的牛仔裤,她的混血面孔加上高挑身材,依然是人群里最耀眼的焦点。
梁思成	林洙	夫妻	1962年,林洙与比她年长27岁的梁思成结婚,因为年龄、学识和生活经历上的差距,引起众多非议。
孙尚香	刘备	夫妻	刘备娶孙尚香之后，便有择日逃离虎穴之心。
钱琳琳	郑弘	夫妻	2004年,张译与郑弘的妻子钱琳琳因广播剧而相恋,令郑弘和钱琳琳的感情出现了裂痕。2006年,钱琳琳与郑弘离婚,火速和张译结婚。
钱琳琳	张译	夫妻	2004年,张译与郑弘的妻子钱琳琳因广播剧而相恋,令郑弘和钱琳琳的感情出现了裂痕。2006年,钱琳琳与郑弘离婚,火速和张译结婚。
吴奇隆	马雅舒	夫妻	2009年8月,吴奇隆马雅舒夫妇离婚传闻一直甚嚣尘上。但双方当事人始终不作回应。
